{
  "version": 1,
  "meta": {
    "name": "level-1-tutorial"
  },
  "settings": {
    "timeLimitMs": 120000,
    "maxTargetsToKill": 5
  },
  "tileSize": 40,
  "cols": 32,
  "rows": 18,
  "tiles": [
    1,1,1,1,1,1,1,1,1,1,1,1,1,1,1,1,1,1,1,1,1,1,1,1,1,1,1,1,1,1,1,1,
    1,0,0,0,0,0,0,0,0,0,0,0,0,0,0,0,0,0,0,0,0,0,0,0,0,0,0,0,0,0,0,0,1,
    1,0,0,0,0,0,0,0,0,0,0,0,0,0,0,0,0,0,0,0,0,0,0,0,0,0,0,0,0,0,0,0,1,
    1,0,0,0,0,0,0,0,0,0,0,0,0,0,0,0,0,0,0,0,0,0,0,0,0,0,0,0,0,0,0,0,1,
    1,0,0,0,0,0,0,0,0,0,0,0,0,0,0,0,0,0,0,0,0,0,0,0,0,0,0,0,0,0,0,0,1,
    1,0,0,0,0,0,0,0,0,0,0,0,0,0,0,0,0,0,0,0,0,0,0,0,0,0,0,0,0,0,0,0,1,
    1,0,0,0,0,0,0,0,0,0,0,0,0,0,0,0,0,0,0,0,0,0,0,0,0,0,0,0,0,0,0,0,1,
    1,0,0,0,0,0,0,0,0,0,0,0,0,0,0,0,0,0,0,0,0,0,0,0,0,0,0,0,0,0,0,0,1,
    1,0,0,0,0,0,0,0,0,0,0,0,0,0,0,0,0,0,0,0,0,0,0,0,0,0,0,0,0,0,0,0,1,
    1,0,0,0,0,0,0,0,0,0,0,0,0,0,0,0,0,0,0,0,0,0,0,0,0,0,0,0,0,0,0,0,1,
    1,0,0,0,0,0,0,0,0,0,0,0,0,0,0,0,0,0,0,0,0,0,0,0,0,0,0,0,0,0,0,0,1,
    1,0,0,0,0,0,0,0,0,0,0,0,0,0,0,0,0,0,0,0,0,0,0,0,0,0,0,0,0,0,0,0,1,
    1,0,0,0,0,0,0,0,0,0,0,0,0,0,0,0,0,0,0,0,0,0,0,0,0,0,0,0,0,0,0,0,1,
    1,0,0,0,0,0,0,0,0,0,0,0,0,0,0,0,0,0,0,0,0,0,0,0,0,0,0,0,0,0,0,0,1,
    1,0,0,0,0,0,0,0,0,0,0,0,0,0,0,0,0,0,0,0,0,0,0,0,0,0,0,0,0,0,0,0,1,
    1,0,0,0,0,0,0,0,0,0,0,0,0,0,0,0,0,0,0,0,0,0,0,0,0,0,0,0,0,0,0,0,1,
    1,0,0,0,0,0,0,0,0,0,0,0,0,0,0,0,0,0,0,0,0,0,0,0,0,0,0,0,0,0,0,0,1,
    1,1,1,1,1,1,1,1,1,1,1,1,1,1,1,1,1,1,1,1,1,1,1,1,1,1,1,1,1,1,1,1
  ],
  "doors": [],
  "playerSpawn": {
    "col": 4,
    "row": 9
  },
  "targetSpawns": [
    { "col": 10, "row": 4 },
    { "col": 16, "row": 6 },
    { "col": 20, "row": 9 },
    { "col": 16, "row": 12 },
    { "col": 10, "row": 14 }
  ],
  "enemies": [
    {
      "id": "enemy-1",
      "type": "melee",
      "spawn": { "col": 24, "row": 9 },
      "patrol": [
        { "col": 24, "row": 5 },
        { "col": 27, "row": 9 },
        { "col": 24, "row": 13 },
        { "col": 21, "row": 9 }
      ]
    }
  ],
  "victoryArea": {
    "col": 28,
    "row": 14,
    "width": 2,
    "height": 2
  },
  "info": {
    "title": "Level 1: Tutorial",
    "body": [
      "Goal: eliminate 5 threats, then reach the green EXIT area.",
      "Time limit: 2:00.",
      "Move with W, A, S, D.",
      "Hold the mouse button to aim and fire. The longer you hold it, the tighter your precision becomes.",
      "Zombies that get too close can block your shooting, so keep space while fighting."
    ]
  }
}
